TTTTTTTTTTTTTTT
T             T
TTT  tRtR  T  T
T  T T TT  TTTT
T  Ttt   tRT  E
T RRTtT   R   T
T   RT  T  R  T
T TT   t  tT  T
TRT RT  T T  TT
R   TRtTTtT R T
T   t   TT  TTT
T  T RRt   R tT
TTTTTTTTTTTTTTT